; 000.txt_map_014
; 0
; 13
##########
##########
##########
####### .#
#######  #
#######.$#
#######$ #
##### $  #
##@$   ..#
##########
