; 552.txt_map_477
; 0
; 476
##########
#        #
#@$ $.$$ #
# ##  #  #
#######..#
########.#
######## #
#######  #
######## #
##########
